1 10 2017 4403 7840 1479 7781 1460 7727 7698 7662 7620 
1 7 3782 7696 3193 7698 1997 7727 3193 
1 8 1157 6783 6755 3421 6747 6766 501 6808 
1 29 6808 2105 6864 6888 6883 3929 1080 1920 1571 6846 6822 1982 1764 2569 3377 2728 3610 6682 2453 6654 6626 1320 2984 3128 6711 195 6779 751 501 
1 10 7953 7956 1451 7961 7972 7980 7998 8023 4420 8085 
1 12 1648 7996 8027 8050 429 8109 8130 8144 8168 884 8212 8221 
1 8 2111 8312 8328 1954 8341 8342 2711 8326 
1 8 8276 878 8247 8229 2557 8188 8169 8146 
1 13 8219 4423 8226 4318 8214 1959 3111 2747 8149 204 8095 8073 3489 
1 6 8111 8133 829 4431 8145 2747 
1 10 3489 8073 8095 8098 1641 8125 2811 8151 1066 8173 
1 5 660 1243 3573 7678 3990 
1 5 641 6985 753 1303 3388 
1 5 641 2456 7001 3327 240 
1 9 641 7036 7058 7076 7118 7137 4881 7159 7142 
1 7 7391 7415 7422 3719 7503 926 7512 
1 8 4953 7883 3383 7866 7860 4563 7792 1008 
1 5 4953 2065 4250 1089 7942 
1 5 4953 4183 7976 3984 1807 
1 8 2844 8652 374 8662 8673 8709 1474 8733 
1 8 8722 8701 8735 8733 1349 514 8812 4013 
1 4 374 8613 8581 2537 
1 2 2844 8733 
1 7 2969 7247 7246 1087 2277 7196 519 
1 8 2969 7208 1336 1027 7215 2310 7292 7336 
1 5 7215 7187 2856 4443 7111 
1 8 2969 178 4212 7344 166 3481 7356 7336 
1 5 2310 7242 4110 4329 2969 
1 4 7356 7329 3980 7242 
1 6 7246 2040 7272 129 3110 7196 
1 8 7272 7308 2887 7376 2358 284 2589 4212 
1 5 1087 7205 7177 4087 2277 
1 9 519 4703 7095 2786 7070 484 4105 7170 1336 
1 8 7208 7170 7164 4961 475 7246 7247 2969 
1 5 7070 612 7148 1327 4961 
1 4 7111 7133 7154 7170 
1 2 6667 6644 
1 18 373 8769 2633 8754 1186 8702 8667 8619 8627 8585 8589 8520 8474 4080 8443 688 8385 8404 
1 3 8754 8781 1496 
1 5 688 8381 8348 8351 8404 
1 6 8434 3541 8473 165 8483 8442 
1 7 2339 507 3417 1738 2071 3155 3092 
1 6 949 2885 9275 9242 1655 3155 
1 5 1197 3689 730 2136 346 
1 8 2000 192 4066 2001 4854 9024 9040 2673 
1 5 192 480 4693 2166 4964 
1 12 2000 8925 8926 8902 8878 2334 8841 4282 8874 3260 8913 8929 192 
1 8 1668 6448 2989 3640 4284 6360 4208 3153 
1 6 6452 3150 6411 2631 4327 4694 
1 3 2631 6397 3401 
1 7 3153 1917 1098 6330 6312 1708 4536 
1 4 1917 4640 2193 2665 
1 5 3974 3321 6326 4750 4133 
1 7 3974 82 6304 6279 4026 2441 6223 
1 6 9349 9336 1227 3266 3104 9411 
1 10 9349 9335 9315 9282 9255 3382 9281 9286 418 9329 
2 19 4578 4222 9022 3241 3176 876 9046 9023 9035 1658 209 8977 8955 8923 8917 8899 2195 8857 8839 
1 6 8882 602 8906 2030 8930 8955 
1 2 8931 8930 
1 13 391 9074 9096 9115 4470 9148 320 1051 9196 9219 4184 188 2627 
1 6 1051 9155 1311 9152 3961 9144 
1 3 3961 9097 9085 
2 8 9219 3621 3614 2208 9314 3770 2948 9359 
1 4 2627 9295 1108 9359 
1 9 391 9119 9139 4889 1168 9181 9206 2436 3614 
2 4 6181 6165 1251 3299 
2 5 4984 6204 6225 3992 6232 
2 3 3299 692 4984 
1 3 4984 4102 6181 
3 6 3299 6138 4641 347 6111 6121 
2 5 6121 6136 1798 6156 1216 
1 4 1216 6183 6214 6232 
3 4 1216 6149 1113 6121 
2 4 6181 6157 6155 6163 
1 2 1798 4921 
1 7 2261 9947 9933 9928 9910 1500 4331 
1 12 4331 9964 3406 9996 1691 1783 10008 1673 9994 4593 9978 2261 
1 4 2261 9955 9946 9949 
1 16 9949 3017 4432 2828 2917 10041 390 10050 10052 10034 4089 9991 9985 1077 9950 9936 
1 5 9936 1180 9938 3791 9949 
1 7 5522 5544 2683 5579 4778 1147 262 
1 7 3523 3263 5243 253 5250 5264 5271 
1 8 5271 5246 5233 56 5201 1520 3316 5159 
1 5 5233 1506 608 745 5304 
1 5 5271 5278 2690 3824 3570 
1 8 3316 5170 5171 5179 3072 2251 5197 2796 
1 9 5189 5195 2222 5214 5202 666 5188 5175 5164 
1 12 5189 5203 5216 176 1316 5257 2949 536 308 5211 5198 5185 
1 8 5189 5203 2503 49 5239 2401 5280 2078 
1 3 666 5209 5228 
1 6 4220 2625 4428 1105 7432 7470 
1 3 7470 1276 7504 
1 11 7470 3692 3446 646 7461 272 2508 7416 3818 7383 4270 
1 8 8402 2207 8450 8495 8545 8597 2042 8651 
1 11 4924 275 8164 286 8115 1740 4918 8033 3458 8020 3912 
1 23 10171 4169 10167 879 10195 4818 10170 3504 4576 10119 4797 515 10051 291 10032 2333 10029 10046 154 10069 2391 10044 10020 
1 4 10020 2192 10025 2435 
1 4 2192 4553 10073 10090 
1 4 10020 1178 9982 9962 
1 8 7711 7737 3399 7805 7846 7881 1217 7898 
1 4 7711 7691 1256 1127 
1 7 1127 7610 7584 323 2884 7583 4628 
1 4 7691 7674 3962 7583 
1 2 1127 4082 
1 5 7707 7682 3884 3540 3908 
1 6 714 6841 6866 2284 2512 6869 
1 9 6869 6898 6905 6912 6926 3210 3197 7007 174 
1 11 9761 2123 9753 9734 9741 9762 3942 9802 3802 9831 3829 
2 5 1053 578 9725 1789 9774 
1 6 1053 1980 9706 9716 9765 9795 
1 6 1980 9670 9660 9626 1174 9575 
1 11 9575 9560 161 9532 2361 9531 2232 9550 950 9552 861 
1 9 1053 9659 9675 2653 9612 9595 801 9552 861 
1 6 1789 1647 900 1049 9625 801 
1 5 9659 2440 2832 9567 9531 
1 10 9795 4655 2023 9746 4416 9701 3018 9613 9598 9575 
1 5 6618 1260 6684 6717 1978 
1 6 1260 3597 3866 6599 3627 4584 
1 2 6510 3341 
1 11 1260 2004 6622 1775 1523 6527 6510 6475 130 6416 6412 
