1 10 2017 4403 7840 1479 7781 1460 7727 7698 7662 7620 
1 7 3782 7696 3193 7698 1997 7727 3193 
1 12 7992 3912 8020 3458 8033 4918 1740 8115 286 8164 275 4924 
1 6 7711 7674 3962 7619 323 3295 
1 6 7711 7737 7748 7787 7813 7846 
1 8 1157 6783 6755 3421 6747 6766 501 6808 
1 29 6808 2105 6864 6888 6883 3929 1080 1920 1571 6846 6822 1982 1764 2569 3377 2728 3610 6682 2453 6654 6626 1320 2984 3128 6711 195 6779 751 501 
