1 10 2017 4403 7840 1479 7781 1460 7727 7698 7662 7620 
1 7 3782 7696 3193 7698 1997 7727 3193 
1 12 7992 3912 8020 3458 8033 4918 1740 8115 286 8164 275 4924 
1 6 7711 7674 3962 7619 323 3295 
1 6 7711 7737 7748 7787 7813 7846 
1 8 1157 6783 6755 3421 6747 6766 501 6808 
1 29 6808 2105 6864 6888 6883 3929 1080 1920 1571 6846 6822 1982 1764 2569 3377 2728 3610 6682 2453 6654 6626 1320 2984 3128 6711 195 6779 751 501 
1 10 7953 7956 1451 7961 7972 7980 7998 8023 4420 8085 
1 12 1648 7996 8027 8050 429 8109 8130 8144 8168 884 8212 8221 
1 8 2111 8312 8328 1954 8341 8342 2711 8326 
1 8 8276 878 8247 8229 2557 8188 8169 8146 
1 13 8219 4423 8226 4318 8214 1959 3111 2747 8149 204 8095 8073 3489 
1 6 8111 8133 829 4431 8145 2747 
1 10 3489 8073 8095 8098 1641 8125 2811 8151 1066 8173 
1 5 660 1243 3573 7678 3990 
1 5 8402 2207 8450 8495 8545 
1 5 641 6985 753 1303 3388 
1 5 641 2456 7001 3327 240 
1 9 641 7036 7058 7076 7118 7137 4881 7159 7142 
1 7 7391 7415 7422 3719 7503 926 7512 
1 8 4953 7883 3383 7866 7860 4563 7792 1008 
1 5 4953 2065 4250 1089 7942 
1 5 4953 4183 7976 3984 1807 
1 8 2844 8652 374 8662 8673 8709 1474 8733 
1 8 8722 8701 8735 8733 1349 514 8812 4013 
1 4 374 8613 8581 2537 
1 2 2844 8733 
1 17 6841 6866 2284 2512 6869 6898 6905 6912 6926 6948 2238 7009 7007 1255 6990 6989 723 
