1 10 2017 4403 7840 1479 7781 1460 7727 7698 7662 7620 
1 7 3782 7696 3193 7698 1997 7727 3193 
1 8 1157 6783 6755 3421 6747 6766 501 6808 
1 29 6808 2105 6864 6888 6883 3929 1080 1920 1571 6846 6822 1982 1764 2569 3377 2728 3610 6682 2453 6654 6626 1320 2984 3128 6711 195 6779 751 501 
1 10 7953 7956 1451 7961 7972 7980 7998 8023 4420 8085 
1 12 1648 7996 8027 8050 429 8109 8130 8144 8168 884 8212 8221 
1 8 2111 8312 8328 1954 8341 8342 2711 8326 
1 8 8276 878 8247 8229 2557 8188 8169 8146 
1 13 8219 4423 8226 4318 8214 1959 3111 2747 8149 204 8095 8073 3489 
1 6 8111 8133 829 4431 8145 2747 
1 10 3489 8073 8095 8098 1641 8125 2811 8151 1066 8173 
1 5 660 1243 3573 7678 3990 
1 5 641 6985 753 1303 3388 
1 5 641 2456 7001 3327 240 
1 9 641 7036 7058 7076 7118 7137 4881 7159 7142 
1 7 7391 7415 7422 3719 7503 926 7512 
1 8 4953 7883 3383 7866 7860 4563 7792 1008 
1 5 4953 2065 4250 1089 7942 
1 5 4953 4183 7976 3984 1807 
1 8 2844 8652 374 8662 8673 8709 1474 8733 
1 8 8722 8701 8735 8733 1349 514 8812 4013 
1 4 374 8613 8581 2537 
1 2 2844 8733 
1 7 2969 7247 7246 1087 2277 7196 519 
1 8 2969 7208 1336 1027 7215 2310 7292 7336 
1 5 7215 7187 2856 4443 7111 
1 8 2969 178 4212 7344 166 3481 7356 7336 
1 5 2310 7242 4110 4329 2969 
1 4 7356 7329 3980 7242 
1 6 7246 2040 7272 129 3110 7196 
1 8 7272 7308 2887 7376 2358 284 2589 4212 
1 5 1087 7205 7177 4087 2277 
1 9 519 4703 7095 2786 7070 484 4105 7170 1336 
1 8 7208 7170 7164 4961 475 7246 7247 2969 
1 5 7070 612 7148 1327 4961 
1 4 7111 7133 7154 7170 
1 2 6667 6644 
1 18 373 8769 2633 8754 1186 8702 8667 8619 8627 8585 8589 8520 8474 4080 8443 688 8385 8404 
1 3 8754 8781 1496 
1 5 688 8381 8348 8351 8404 
1 7 2339 507 3417 1738 2071 3155 3092 
1 6 949 2885 9275 9242 1655 3155 
1 5 1197 3689 730 2136 346 
1 8 2000 192 4066 2001 4854 9024 9040 2673 
1 5 192 480 4693 2166 4964 
1 13 2000 8925 8926 8902 8878 2334 8841 4282 8874 3260 8913 8929 192 
1 8 8459 8434 3541 8533 709 8664 8697 8726 
1 9 10817 10802 3334 1537 2839 905 10700 10679 4355 
1 6 2839 10764 10747 10730 10718 3392 
1 11 1448 10448 3352 1222 4410 10361 10355 10337 3788 10291 3068 
1 6 10412 10400 4352 10374 10367 10355 
1 13 3220 11108 2957 11149 11163 11171 14 11213 1230 11268 3046 11331 11373 
1 2 3220 4897 
1 15 10071 10088 10101 4364 10133 10117 10124 3058 10120 10137 733 10130 1160 10078 986 
1 7 6559 6596 6601 6623 2980 2350 6644 
1 3 4369 6759 3189 
1 10 3749 11110 3813 11129 11116 1611 11157 3105 11230 4756 
3 6 3299 6138 4641 347 6111 6121 
1 4 1216 6149 6136 6121 
2 3 6136 1798 4921 
1 4 6232 6214 6183 1216 
2 5 6181 4102 4984 692 3299 
1 4 6181 6165 1251 3299 
1 4 6163 6155 6157 6181 
1 5 4984 6204 6225 3992 6232 
3 9 4971 8007 8035 4395 8048 8052 2827 3119 7978 
1 6 3386 3031 8114 4166 8065 8052 
1 6 87 8139 8117 4606 8079 8052 
1 6 8097 8086 186 8081 8079 8052 
2 3 5271 5246 5233 
1 7 3523 3263 5243 253 5250 5264 5271 
1 5 3570 3824 2690 5278 5271 
1 6 2437 5306 2779 1402 5232 2796 
1 10 1402 5261 608 1506 5233 5218 4796 5201 1520 3316 
1 5 42 4453 1525 5522 5544 
1 7 5544 2683 5579 4778 1971 5645 262 
2 9 4220 2625 7351 1561 1105 3692 7470 1276 7504 
1 3 3692 3446 646 
1 8 646 3602 3896 2130 272 2508 7416 4270 
1 10 1155 7802 1910 7810 3836 3032 520 4829 660 7625 
1 3 4034 7749 3990 
1 18 8651 2042 8597 8545 8495 8450 2207 8402 8363 1145 1507 8358 3186 8424 8466 8511 4735 8595 
1 6 20 9351 2850 9259 796 2016 
1 3 4250 409 7786 
1 3 2805 3565 3984 
1 12 10312 10335 3833 2575 1193 10376 4072 10408 10436 10455 443 1797 
1 9 443 2449 4835 10503 4545 2293 10472 855 1596 
3 9 35 8038 8010 7988 3312 3707 2385 836 524 
2 7 7898 1217 7839 7846 7805 7813 7787 
1 4 7805 3399 7737 7711 
1 7 7711 7691 7666 7619 2884 3295 3865 
1 2 8474 2813 
1 4 1478 4834 1340 137 
1 6 2364 7864 281 7848 7863 7847 
2 10 9329 418 1129 1239 1878 9335 9349 9336 1227 3266 
1 9 9411 4201 3467 9436 9448 158 3033 2199 9349 
1 11 4600 11537 11525 11518 11519 11508 4020 11526 11539 1963 2562 
1 8 11292 11274 11240 512 1752 3020 11114 2629 
1 9 3466 336 11271 11296 11284 11272 11262 2077 11274 
3 7 10524 4307 10540 10519 10523 10504 3654 
1 10 10626 145 2274 4418 10524 3095 1429 680 4359 222 
1 3 4639 10596 10617 
1 2 10429 2919 
1 4 2279 10440 1420 10429 
2 39 4916 3555 4227 4875 1125 9813 1257 9837 9849 9836 3808 2551 9817 9812 9771 9751 9732 885 1333 9664 9632 4278 4495 9558 3925 4293 9558 3925 9492 3438 9474 2735 9475 9484 9501 9519 9549 9541 94 
1 2 4916 94 
1 5 9910 9928 9933 9947 4331 
1 7 9947 2261 9978 9996 1691 1783 10008 
1 4 2828 4432 3017 9949 
1 2 3017 9938 
1 6 2828 1760 9985 1077 9950 9936 
1 8 2828 10009 2917 10041 390 10050 10052 10034 
1 4 10008 1673 9965 9949 
1 10 10169 10207 3139 3019 2595 10295 10321 4858 10363 10388 
1 6 10861 10849 10844 3723 10818 4203 
1 6 10727 10756 3923 4048 1771 3723 
1 7 10750 1527 10772 1979 10774 208 4048 
1 8 11007 337 3822 11015 11002 10990 2567 10970 
1 17 3672 10660 10666 375 4016 10586 2738 2513 4833 325 10542 10536 10539 10515 10485 987 10441 
1 7 4759 10575 10589 10561 866 10549 10539 
1 16 10254 10220 4180 10193 10172 747 1354 10142 10131 3966 10110 10102 1111 10082 10062 52 
1 5 3894 1034 10164 10150 3966 
1 7 10023 3949 10059 10074 10093 10114 3966 
1 5 747 10141 1195 4498 4551 
2 18 11012 3986 10987 1101 10984 2126 2439 10978 4402 1512 1956 2167 10912 3132 4299 2057 10894 3758 
1 9 3546 11370 725 11333 2021 11288 11263 4507 11200 
1 11 725 11321 11309 952 11232 11238 11245 11215 1423 11236 11241 
1 7 11232 11208 363 11167 11145 4779 11099 
1 8 12057 12067 12077 12149 12076 12069 12068 12065 
1 9 10842 8200 7084 10847 7106 7121 10805 8122 7077 
1 7 84 10342 4977 10346 1309 10389 1560 
1 15 84 10342 1887 2597 4448 10253 10226 1513 1363 10214 10246 10250 10271 4514 10309 
1 5 10271 10250 10257 10238 3953 
1 6 10309 3359 486 1514 10396 993 
1 5 3775 9961 109 3332 10000 
1 5 109 2560 2971 9930 9931 
1 8 85 10001 9981 9969 9958 9945 1627 9931 
1 2 3304 85 
1 6 9931 1627 3801 9909 9912 9916 
1 5 9909 9896 2095 9872 9867 
1 5 9930 1741 2013 1362 9855 
3 9 9531 9567 2832 2440 9667 1053 9733 9765 9795 
1 5 9774 1789 9725 578 1053 
1 6 861 9552 950 4401 3892 2832 
1 5 1049 9654 2653 1436 2440 
1 7 9701 9684 9668 9660 9638 1386 2440 
1 13 4924 275 286 8115 1740 4918 8033 3458 8020 3912 7992 7987 7973 
1 4 3458 4912 8000 103 
1 2 621 4491 
1 5 7658 7598 859 7494 4794 
1 6 4794 7453 4408 4800 425 7391 
1 2 742 3225 
1 10 2981 5331 5345 4601 5363 1732 3016 5375 5380 185 
1 7 1314 4136 5413 330 5392 4106 5380 
1 7 5380 5369 4557 3112 5317 2493 5277 
2 9 5101 1557 5095 649 5093 5078 3296 5051 2438 
1 7 5045 3243 5052 4231 90 326 3296 
1 4 780 5521 5542 1800 
1 4 5497 2510 5518 780 
1 6 780 5521 895 396 4594 5481 
1 11 12253 12254 12256 12260 12261 12264 12262 12268 12270 12274 12277 
1 7 12239 12238 12233 12235 12267 12269 12268 
1 7 12331 12337 12407 12344 12343 12341 12342 
1 10 566 5502 2160 5483 839 782 3205 5440 3255 112 
1 6 5185 5198 5193 5186 5184 244 
1 12 5320 5301 2078 5280 3828 150 5265 1316 176 4585 5189 244 
1 4 5214 2222 5195 5189 
1 3 2949 5257 1316 
1 4 5228 5209 5191 5175 
1 5 5214 5190 1906 5188 5191 
1 6 9023 8998 8979 8955 3385 8931 
2 6 8955 8930 2030 8906 602 8882 
1 7 9023 9046 876 48 4922 4222 4578 
1 3 9092 4036 876 
1 7 8979 4287 2201 8899 2195 8857 8839 
1 11 3614 3621 9219 9196 1051 9155 9146 4470 9148 66 391 
1 3 9148 9131 9096 
1 5 9144 3961 3144 9097 9085 
1 3 9155 1311 3144 
1 5 9359 2948 1472 9295 2627 
1 4 9219 4184 188 9295 
1 7 4758 5717 2593 4660 2025 5784 3778 
1 8 3974 4071 6381 898 423 6450 1395 4763 
1 6 3974 6338 6322 6326 4750 4133 
1 7 6338 82 6304 790 4026 2441 6223 
1 6 82 6332 2945 6323 6315 6310 
1 14 4616 8403 8441 8445 2920 1896 8459 8434 3541 3622 4634 1694 8324 3917 
1 11 355 11536 11516 229 11505 2225 108 11484 11481 1241 1013 
1 4 11504 11495 3725 1241 
1 5 229 11499 4113 3242 11469 
1 6 11381 11362 11337 11314 11294 11282 
1 5 11423 979 4108 3215 11381 
1 6 11436 592 11424 11418 11413 3215 
1 3 11425 1308 11424 
1 7 11403 652 2584 11389 11398 2841 11381 
1 5 11372 1213 4407 1890 11381 
1 5 11405 11400 1358 11386 11372 
1 5 12820 12808 12807 12800 12786 
1 9 12808 12805 12804 12803 12802 12796 12795 12792 12791 
1 8 4598 9581 3897 3217 3500 9570 3991 735 
2 15 735 9548 9538 9505 989 2574 4457 569 9385 1590 9361 858 2816 9340 3781 
1 4 989 9441 9463 4950 
1 5 242 9420 2912 1504 3434 
1 6 3897 4721 3747 9457 9432 9420 
2 15 68 8604 8564 3275 8542 8506 8477 4084 990 8663 362 8732 8760 1359 8780 
1 7 1359 3478 4684 2154 8808 8823 8809 
1 8 8477 4568 4235 8392 263 8393 8405 2860 
1 7 345 1921 8766 8742 8756 3696 8786 
1 5 526 3444 8687 8655 1930 
1 4 8700 8670 8640 8623 
1 10 956 1688 8550 8601 1086 8522 8534 4908 8488 8456 
1 2 8655 1086 
1 2 8742 3444 
1 10 8522 8480 8437 3548 3664 1368 4747 445 8337 3319 
1 4 3664 8349 1721 8316 
1 2 1688 8493 
1 4 1688 8559 8543 3556 
1 11 3820 4051 4974 5140 4050 6131 6199 5142 6960 5152 4093 
1 4 5165 5169 5157 4288 
1 5 6161 5146 6210 5165 3820 
1 7 6147 4732 4433 5176 7008 4672 6162 
1 5 5176 6178 4019 5138 5140 
1 8 4295 6176 4361 5187 6949 6205 5181 5140 
1 4 5187 4894 5143 5154 
1 4 6188 7017 6233 5142 
1 3 6970 5127 5181 
1 3 6237 4871 5138 
1 4 6952 5132 7041 5140 
1 4 5131 4176 6193 5140 
1 12 3415 8661 8624 104 4275 8448 2091 2953 8368 8382 826 8376 
1 5 3411 8333 2324 8375 2953 
1 10 2985 381 4841 597 2539 503 9118 2496 9090 1466 
2 8 503 9093 1151 1703 9047 3065 9014 765 
3 5 1703 9028 4512 3705 8972 
2 19 1394 441 10782 10777 4482 10776 479 10745 10729 10719 10698 4422 3485 3510 4817 4140 1242 10599 10583 
1 4 11033 4175 11001 10990 
1 4 3815 3001 11001 10990 
1 3 10990 1503 767 
1 11 1836 887 11046 92 583 4583 2031 11064 11073 11082 11092 
1 5 11057 1445 1481 138 11046 
1 7 10957 3712 10946 10958 3740 10955 10937 
1 6 9481 9455 9431 9407 3535 20 
1 4 9479 3160 1329 9407 
1 9 1455 1432 9352 4686 1023 9429 231 3999 9455 
1 3 9352 9328 4244 
1 7 3535 9355 453 1639 4097 9251 9224 
3 7 3785 2916 2999 3375 3343 3457 2851 
1 6 2999 3419 3685 2952 3683 3343 
1 3 3685 3129 3494 
1 3 2952 3129 3494 
1 3 619 5888 518 
1 5 5974 4126 1433 5938 619 
1 7 5594 352 3131 1170 4337 37 214 
2 9 37 5604 5628 5642 508 5639 5640 5607 5601 
1 5 2152 2847 5690 5671 5642 
1 7 12395 12396 12365 12367 12405 12370 12344 
1 5 579 5910 1546 1714 5953 
1 5 579 3648 5853 5864 5852 
1 7 579 287 5857 3106 295 4990 2051 
1 8 295 5834 4782 5830 788 5814 2072 5795 
1 14 1777 2674 3586 6151 3559 1075 1931 677 6100 6088 1380 559 1287 3960 
1 13 2049 6305 4386 6302 1837 4603 6331 6349 6365 6387 399 4493 525 
1 5 6378 6361 6353 6342 4603 
1 4 269 6362 6349 6331 
1 6 12757 12663 12760 12762 12763 12764 
1 10 12764 12728 12766 12727 12749 12771 12772 12712 12713 12220 
1 6 12752 12667 12689 12723 12691 12762 
2 7 6753 574 4347 1076 6728 264 124 
1 4 124 477 1302 6696 
1 11 1302 6669 285 3878 6570 743 6547 4308 2719 6526 6537 
1 2 2719 6459 
1 9 4509 2458 6945 4949 2733 6940 580 6943 4926 
1 8 6909 6942 2727 4191 6983 2006 3370 4509 
1 11 447 7483 3367 7473 7447 7411 7388 7364 3130 7342 7304 
1 4 447 586 7359 787 
1 6 7326 2607 7253 1938 7212 4012 
1 7 7253 3052 7227 7204 7173 511 3192 
1 4 7173 4185 1498 3871 
1 6 7796 3784 7789 3124 3890 4426 
1 8 3124 7744 7713 7684 7656 913 7614 7580 
1 4 913 259 3418 7527 
1 8 7713 7684 754 7653 4987 7577 7555 1544 
2 10 2140 1758 2198 2041 1376 1559 1706 2612 2209 1768 
1 2 1768 2140 
1 5 2612 2564 2029 1379 1758 
1 5 1376 1900 2029 1189 1768 
1 5 1737 7102 7063 7044 3136 
1 6 3136 3681 6978 6995 6975 6979 
1 5 7429 7403 7378 727 1196 
1 4 727 509 2959 7347 
1 4 7467 4826 7396 7347 
1 7 4826 7413 7430 2502 4618 7393 7400 
1 12 1408 7199 7206 4789 533 7193 1784 280 7189 2331 7218 172 
1 7 1784 7130 7103 1091 2470 918 7075 
1 5 1091 7042 4547 7037 3174 
1 12 1911 8708 1799 8635 8612 912 4904 4780 8389 8395 8413 8439 
2 6 1911 1210 2862 4246 8561 8551 
1 6 1911 8708 1799 8713 8749 8771 
1 4 4904 8524 2930 2888 
1 4 640 8942 2019 2247 
1 3 8954 202 2445 
1 2 640 8954 
1 3 1970 8949 8954 
1 6 640 8997 9011 9039 9079 9106 
1 4 2019 8965 8984 8967 
1 9 73 9396 9400 2706 2801 2543 2621 9354 9369 
3 6 10683 10692 10672 10656 3695 226 
1 4 10683 4851 451 98 
1 3 10706 4419 10683 
1 4 10686 10667 10668 1974 
1 6 1974 157 3437 4798 2061 10582 
1 4 2061 10567 2651 1374 
1 3 10195 4818 10170 
1 5 10195 879 10185 10171 4169 
1 5 10090 3922 482 10039 2435 
1 4 2192 10020 1178 9982 
1 4 10029 44 9997 9982 
1 4 10119 10097 654 515 
1 4 654 10070 2602 10029 
1 6 9761 3594 9720 119 9734 9741 
1 7 3829 3064 9803 1562 3942 9762 9741 
1 6 9741 9714 1796 9676 4452 9628 
1 6 9741 207 236 9838 4943 1325 
1 7 9838 236 9818 9839 9827 3802 9803 
1 4 9816 9787 9753 119 
1 2 9816 236 
1 5 1562 1697 9731 4269 4452 
1 11 3006 1485 9601 794 9533 9546 2371 9485 9472 2784 9461 
1 3 9750 19 9677 
1 8 794 1085 9540 1068 9557 356 9609 3133 
2 15 4326 96 1341 9942 3537 669 4567 3248 2736 9844 2403 133 9826 3190 3972 
1 5 669 9918 9907 189 9921 
1 4 9844 2217 9828 9801 
1 13 268 4698 914 8858 8868 2998 8908 8903 8912 1387 3629 8971 8961 
1 6 1172 8985 4648 1378 710 8908 
1 10 4698 1469 8813 8807 2926 721 8831 2758 8814 8793 
1 14 1978 6717 6684 1260 6618 6614 6622 1775 1523 6566 3341 6575 2774 163 
1 5 1523 6496 6461 6424 6390 
1 6 6461 1278 6475 2770 6416 6412 
1 9 1775 6581 587 81 6531 811 6504 6520 4584 
1 3 6618 354 6599 
1 3 1260 6671 6688 
1 9 6541 3049 635 6550 6573 6553 4622 121 6539 
1 7 3724 6714 6687 173 6648 2009 6553 
1 7 1967 6750 1266 6720 6733 6743 3724 
1 9 12592 12591 12593 12594 12575 12576 12577 12578 12583 
1 5 12618 12621 12613 12604 12594 
1 5 5799 3493 5797 2660 2180 
1 13 12412 12413 12439 12438 12443 12446 12444 12445 12454 12480 12481 12414 12489 
1 5 5658 2190 3924 5678 198 
1 10 5678 1369 5675 5662 2776 5633 5615 333 5624 674 
1 6 5633 5616 3055 2327 5561 4149 
1 5 2776 5676 5699 1224 5739 
1 3 5616 5632 4398 
4 7 766 5386 538 5356 5348 5344 5336 
1 8 5336 3034 5313 5323 5337 3582 2477 607 
1 8 5367 132 5335 1533 2384 5326 2810 5336 
1 7 1846 4118 3830 4752 3313 5066 601 
1 10 5121 5113 180 2139 5090 1231 5065 953 5038 939 
1 6 2050 903 5087 1802 167 5058 
1 3 5129 5124 2050 
1 6 167 5054 3107 5034 2102 5023 
1 3 5034 5025 5022 
1 6 601 1069 5031 5019 5012 5005 
1 4 5054 3609 4582 5066 
1 10 3320 2989 3640 4284 6360 435 6330 3381 2309 4536 
1 8 452 4284 6360 4208 3153 1917 4640 2193 
1 5 6452 6419 3845 4574 3153 
1 6 6452 6420 3150 6411 6397 3401 
1 4 6411 2631 4327 4694 
1 2 3381 1708 
1 10 714 6841 2284 2512 6869 6898 6905 3289 3210 6926 
1 5 7072 174 7007 3197 3210 
1 8 6606 6640 6638 6619 6611 6630 2909 4240 
1 10 449 2531 4846 2767 871 434 6484 6523 1290 6611 
1 11 7717 3572 3660 1654 7638 7596 7603 7575 7579 3152 4866 
1 7 12986 12987 12984 12985 12990 12993 12981 
1 4 12985 13002 13008 13013 
1 5 12990 13000 13009 13007 13026 
1 4 13009 13021 13022 13023 
1 6 6228 6247 2344 6261 521 4473 
1 8 6494 3393 6463 6438 6402 6377 3358 2591 
1 5 6430 4336 4249 6348 3558 
1 8 4473 6318 6335 4793 3661 1785 2431 3393 
1 5 4249 1932 3889 6320 6318 
1 7 6072 4588 3474 6036 2823 4982 812 
1 6 6063 6057 6046 376 6034 6036 
1 12 12960 12959 12946 12947 12935 12934 12928 12917 12916 12918 12919 12920 
1 7 12934 12928 12931 12937 12939 12941 12942 
