1 10 2017 4403 7840 1479 7781 1460 7727 7698 7662 7620 
1 7 3782 7696 3193 7698 1997 7727 3193 
1 8 1157 6783 6755 3421 6747 6766 501 6808 
1 29 6808 2105 6864 6888 6883 3929 1080 1920 1571 6846 6822 1982 1764 2569 3377 2728 3610 6682 2453 6654 6626 1320 2984 3128 6711 195 6779 751 501 
1 10 7953 7956 1451 7961 7972 7980 7998 8023 4420 8085 
1 12 1648 7996 8027 8050 429 8109 8130 8144 8168 884 8212 8221 
1 8 2111 8312 8328 1954 8341 8342 2711 8326 
1 8 8276 878 8247 8229 2557 8188 8169 8146 
1 13 8219 4423 8226 4318 8214 1959 3111 2747 8149 204 8095 8073 3489 
1 6 8111 8133 829 4431 8145 2747 
1 10 3489 8073 8095 8098 1641 8125 2811 8151 1066 8173 
1 5 660 1243 3573 7678 3990 
1 5 641 6985 753 1303 3388 
1 5 641 2456 7001 3327 240 
1 9 641 7036 7058 7076 7118 7137 4881 7159 7142 
1 7 7391 7415 7422 3719 7503 926 7512 
1 8 4953 7883 3383 7866 7860 4563 7792 1008 
1 5 4953 2065 4250 1089 7942 
1 5 4953 4183 7976 3984 1807 
1 8 2844 8652 374 8662 8673 8709 1474 8733 
1 8 8722 8701 8735 8733 1349 514 8812 4013 
1 4 374 8613 8581 2537 
1 2 2844 8733 
1 7 2969 7247 7246 1087 2277 7196 519 
1 8 2969 7208 1336 1027 7215 2310 7292 7336 
1 5 7215 7187 2856 4443 7111 
1 8 2969 178 4212 7344 166 3481 7356 7336 
1 5 2310 7242 4110 4329 2969 
1 4 7356 7329 3980 7242 
1 6 7246 2040 7272 129 3110 7196 
1 8 7272 7308 2887 7376 2358 284 2589 4212 
1 5 1087 7205 7177 4087 2277 
1 9 519 4703 7095 2786 7070 484 4105 7170 1336 
1 8 7208 7170 7164 4961 475 7246 7247 2969 
1 5 7070 612 7148 1327 4961 
1 4 7111 7133 7154 7170 
1 2 6667 6644 
1 18 373 8769 2633 8754 1186 8702 8667 8619 8627 8585 8589 8520 8474 4080 8443 688 8385 8404 
1 3 8754 8781 1496 
1 5 688 8381 8348 8351 8404 
1 7 2339 507 3417 1738 2071 3155 3092 
1 6 949 2885 9275 9242 1655 3155 
1 5 1197 3689 730 2136 346 
1 8 2000 192 4066 2001 4854 9024 9040 2673 
1 5 192 480 4693 2166 4964 
1 13 2000 8925 8926 8902 8878 2334 8841 4282 8874 3260 8913 8929 192 
1 8 8459 8434 3541 8533 709 8664 8697 8726 
1 9 10817 10802 3334 1537 2839 905 10700 10679 4355 
1 6 2839 10764 10747 10730 10718 3392 
1 11 1448 10448 3352 1222 4410 10361 10355 10337 3788 10291 3068 
1 6 10412 10400 4352 10374 10367 10355 
1 13 3220 11108 2957 11149 11163 11171 14 11213 1230 11268 3046 11331 11373 
1 2 3220 4897 
1 15 10071 10088 10101 4364 10133 10117 10124 3058 10120 10137 733 10130 1160 10078 986 
1 7 6559 6596 6601 6623 2980 2350 6644 
1 3 4369 6759 3189 
1 10 3749 11110 3813 11129 11116 1611 11157 3105 11230 4756 
